Columns: 39
Rows: 22
000000000000000000000000000000000000000
000000000000000000000000000000000000000
000000000000000000000000000000000000000
000000000000000000000000000000000000000
000000000000000000000000000000000000000
000000000000000343434340000000000000000
000001100000020565656560000000000000000
000000110000020343434340000000000000000
000000222222220565656560000000000000000
000000000110000003434340000000000000000
000000022222002205656560000000000000000
000000000220002200000000000000000000000
000000340000000000000000000000000000000
000000560034000000000000000000000000000
000000000056000000000000000000000000000
000000000000000000000000000000000000000
000000000000000000000000000000000000000
000000000000000000000000000000000000000
000000000000000000000000000000000000000
000000000000000000000000000000000000000
000000000000000000000000000000000000000
000000000000000000000000000000000000000
